# L=greek
# grep-utf8.sh $L | perl -pne 's{\A.+(\[[a-z]+\]).+\z}{$1\n}xmsgi' | sort |uniq
# mkdir $L; (for f in LetterNumber OtherNumber MathSymbol ModifierLetter OtherPunctuation OtherSymbol ModifierSymbol NonspacingMark UppercaseLetter TitlecaseLetter LowercaseLetter; do perl -e 'print "\n"'; grep-utf8.sh $L | grep $f;  done) > $L/utf8.txt

êÖÄ	U+10140	[LetterNumber]	GREEK ACROPHONIC ATTIC ONE QUARTER
êÖÅ	U+10141	[LetterNumber]	GREEK ACROPHONIC ATTIC ONE HALF
êÖÇ	U+10142	[LetterNumber]	GREEK ACROPHONIC ATTIC ONE DRACHMA
êÖÉ	U+10143	[LetterNumber]	GREEK ACROPHONIC ATTIC FIVE
êÖÑ	U+10144	[LetterNumber]	GREEK ACROPHONIC ATTIC FIFTY
êÖÖ	U+10145	[LetterNumber]	GREEK ACROPHONIC ATTIC FIVE HUNDRED
êÖÜ	U+10146	[LetterNumber]	GREEK ACROPHONIC ATTIC FIVE THOUSAND
êÖá	U+10147	[LetterNumber]	GREEK ACROPHONIC ATTIC FIFTY THOUSAND
êÖà	U+10148	[LetterNumber]	GREEK ACROPHONIC ATTIC FIVE TALENTS
êÖâ	U+10149	[LetterNumber]	GREEK ACROPHONIC ATTIC TEN TALENTS
êÖä	U+1014A	[LetterNumber]	GREEK ACROPHONIC ATTIC FIFTY TALENTS
êÖã	U+1014B	[LetterNumber]	GREEK ACROPHONIC ATTIC ONE HUNDRED TALENTS
êÖå	U+1014C	[LetterNumber]	GREEK ACROPHONIC ATTIC FIVE HUNDRED TALENTS
êÖç	U+1014D	[LetterNumber]	GREEK ACROPHONIC ATTIC ONE THOUSAND TALENTS
êÖé	U+1014E	[LetterNumber]	GREEK ACROPHONIC ATTIC FIVE THOUSAND TALENTS
êÖè	U+1014F	[LetterNumber]	GREEK ACROPHONIC ATTIC FIVE STATERS
êÖê	U+10150	[LetterNumber]	GREEK ACROPHONIC ATTIC TEN STATERS
êÖë	U+10151	[LetterNumber]	GREEK ACROPHONIC ATTIC FIFTY STATERS
êÖí	U+10152	[LetterNumber]	GREEK ACROPHONIC ATTIC ONE HUNDRED STATERS
êÖì	U+10153	[LetterNumber]	GREEK ACROPHONIC ATTIC FIVE HUNDRED STATERS
êÖî	U+10154	[LetterNumber]	GREEK ACROPHONIC ATTIC ONE THOUSAND STATERS
êÖï	U+10155	[LetterNumber]	GREEK ACROPHONIC ATTIC TEN THOUSAND STATERS
êÖñ	U+10156	[LetterNumber]	GREEK ACROPHONIC ATTIC FIFTY THOUSAND STATERS
êÖó	U+10157	[LetterNumber]	GREEK ACROPHONIC ATTIC TEN MNAS
êÖò	U+10158	[LetterNumber]	GREEK ACROPHONIC HERAEUM ONE PLETHRON
êÖô	U+10159	[LetterNumber]	GREEK ACROPHONIC THESPIAN ONE
êÖö	U+1015A	[LetterNumber]	GREEK ACROPHONIC HERMIONIAN ONE
êÖõ	U+1015B	[LetterNumber]	GREEK ACROPHONIC EPIDAUREAN TWO
êÖú	U+1015C	[LetterNumber]	GREEK ACROPHONIC THESPIAN TWO
êÖù	U+1015D	[LetterNumber]	GREEK ACROPHONIC CYRENAIC TWO DRACHMAS
êÖû	U+1015E	[LetterNumber]	GREEK ACROPHONIC EPIDAUREAN TWO DRACHMAS
êÖü	U+1015F	[LetterNumber]	GREEK ACROPHONIC TROEZENIAN FIVE
êÖ†	U+10160	[LetterNumber]	GREEK ACROPHONIC TROEZENIAN TEN
êÖ°	U+10161	[LetterNumber]	GREEK ACROPHONIC TROEZENIAN TEN ALTERNATE FORM
êÖ¢	U+10162	[LetterNumber]	GREEK ACROPHONIC HERMIONIAN TEN
êÖ£	U+10163	[LetterNumber]	GREEK ACROPHONIC MESSENIAN TEN
êÖ§	U+10164	[LetterNumber]	GREEK ACROPHONIC THESPIAN TEN
êÖ•	U+10165	[LetterNumber]	GREEK ACROPHONIC THESPIAN THIRTY
êÖ¶	U+10166	[LetterNumber]	GREEK ACROPHONIC TROEZENIAN FIFTY
êÖß	U+10167	[LetterNumber]	GREEK ACROPHONIC TROEZENIAN FIFTY ALTERNATE FORM
êÖ®	U+10168	[LetterNumber]	GREEK ACROPHONIC HERMIONIAN FIFTY
êÖ©	U+10169	[LetterNumber]	GREEK ACROPHONIC THESPIAN FIFTY
êÖ™	U+1016A	[LetterNumber]	GREEK ACROPHONIC THESPIAN ONE HUNDRED
êÖ´	U+1016B	[LetterNumber]	GREEK ACROPHONIC THESPIAN THREE HUNDRED
êÖ¨	U+1016C	[LetterNumber]	GREEK ACROPHONIC EPIDAUREAN FIVE HUNDRED
êÖ≠	U+1016D	[LetterNumber]	GREEK ACROPHONIC TROEZENIAN FIVE HUNDRED
êÖÆ	U+1016E	[LetterNumber]	GREEK ACROPHONIC THESPIAN FIVE HUNDRED
êÖØ	U+1016F	[LetterNumber]	GREEK ACROPHONIC CARYSTIAN FIVE HUNDRED
êÖ∞	U+10170	[LetterNumber]	GREEK ACROPHONIC NAXIAN FIVE HUNDRED
êÖ±	U+10171	[LetterNumber]	GREEK ACROPHONIC THESPIAN ONE THOUSAND
êÖ≤	U+10172	[LetterNumber]	GREEK ACROPHONIC THESPIAN FIVE THOUSAND
êÖ≥	U+10173	[LetterNumber]	GREEK ACROPHONIC DELPHIC FIVE MNAS
êÖ¥	U+10174	[LetterNumber]	GREEK ACROPHONIC STRATIAN FIFTY MNAS

êÖµ	U+10175	[OtherNumber]	GREEK ONE HALF SIGN
êÖ∂	U+10176	[OtherNumber]	GREEK ONE HALF SIGN ALTERNATE FORM
êÖ∑	U+10177	[OtherNumber]	GREEK TWO THIRDS SIGN
êÖ∏	U+10178	[OtherNumber]	GREEK THREE QUARTERS SIGN
êÜä	U+1018A	[OtherNumber]	GREEK ZERO SIGN

œ∂	U+3F6	[MathSymbol]	GREEK REVERSED LUNATE EPSILON SYMBOL

Õ¥	U+374	[ModifierLetter]	GREEK NUMERAL SIGN
Õ∫	U+37A	[ModifierLetter]	GREEK YPOGEGRAMMENI
·µû	U+1D5E	[ModifierLetter]	MODIFIER LETTER SMALL GREEK GAMMA
·µ†	U+1D60	[ModifierLetter]	MODIFIER LETTER SMALL GREEK PHI
·µ¶	U+1D66	[ModifierLetter]	GREEK SUBSCRIPT SMALL LETTER BETA
·µß	U+1D67	[ModifierLetter]	GREEK SUBSCRIPT SMALL LETTER GAMMA
·µ®	U+1D68	[ModifierLetter]	GREEK SUBSCRIPT SMALL LETTER RHO
·µ©	U+1D69	[ModifierLetter]	GREEK SUBSCRIPT SMALL LETTER PHI
·µ™	U+1D6A	[ModifierLetter]	GREEK SUBSCRIPT SMALL LETTER CHI

Õæ	U+37E	[OtherPunctuation]	GREEK QUESTION MARK
Œá	U+387	[OtherPunctuation]	GREEK ANO TELEIA

‚Ñ©	U+2129	[OtherSymbol]	TURNED GREEK SMALL LETTER IOTA
‚úô	U+2719	[OtherSymbol]	OUTLINED GREEK CROSS
‚úö	U+271A	[OtherSymbol]	HEAVY GREEK CROSS
êÖπ	U+10179	[OtherSymbol]	GREEK YEAR SIGN
êÖ∫	U+1017A	[OtherSymbol]	GREEK TALENT SIGN
êÖª	U+1017B	[OtherSymbol]	GREEK DRACHMA SIGN
êÖº	U+1017C	[OtherSymbol]	GREEK OBOL SIGN
êÖΩ	U+1017D	[OtherSymbol]	GREEK TWO OBOLS SIGN
êÖæ	U+1017E	[OtherSymbol]	GREEK THREE OBOLS SIGN
êÖø	U+1017F	[OtherSymbol]	GREEK FOUR OBOLS SIGN
êÜÄ	U+10180	[OtherSymbol]	GREEK FIVE OBOLS SIGN
êÜÅ	U+10181	[OtherSymbol]	GREEK METRETES SIGN
êÜÇ	U+10182	[OtherSymbol]	GREEK KYATHOS BASE SIGN
êÜÉ	U+10183	[OtherSymbol]	GREEK LITRA SIGN
êÜÑ	U+10184	[OtherSymbol]	GREEK OUNKIA SIGN
êÜÖ	U+10185	[OtherSymbol]	GREEK XESTES SIGN
êÜÜ	U+10186	[OtherSymbol]	GREEK ARTABE SIGN
êÜá	U+10187	[OtherSymbol]	GREEK AROURA SIGN
êÜà	U+10188	[OtherSymbol]	GREEK GRAMMA SIGN
êÜâ	U+10189	[OtherSymbol]	GREEK TRYBLION BASE SIGN
ùàÄ	U+1D200	[OtherSymbol]	GREEK VOCAL NOTATION SYMBOL-1
ùàÅ	U+1D201	[OtherSymbol]	GREEK VOCAL NOTATION SYMBOL-2
ùàÇ	U+1D202	[OtherSymbol]	GREEK VOCAL NOTATION SYMBOL-3
ùàÉ	U+1D203	[OtherSymbol]	GREEK VOCAL NOTATION SYMBOL-4
ùàÑ	U+1D204	[OtherSymbol]	GREEK VOCAL NOTATION SYMBOL-5
ùàÖ	U+1D205	[OtherSymbol]	GREEK VOCAL NOTATION SYMBOL-6
ùàÜ	U+1D206	[OtherSymbol]	GREEK VOCAL NOTATION SYMBOL-7
ùàá	U+1D207	[OtherSymbol]	GREEK VOCAL NOTATION SYMBOL-8
ùàà	U+1D208	[OtherSymbol]	GREEK VOCAL NOTATION SYMBOL-9
ùàâ	U+1D209	[OtherSymbol]	GREEK VOCAL NOTATION SYMBOL-10
ùàä	U+1D20A	[OtherSymbol]	GREEK VOCAL NOTATION SYMBOL-11
ùàã	U+1D20B	[OtherSymbol]	GREEK VOCAL NOTATION SYMBOL-12
ùàå	U+1D20C	[OtherSymbol]	GREEK VOCAL NOTATION SYMBOL-13
ùàç	U+1D20D	[OtherSymbol]	GREEK VOCAL NOTATION SYMBOL-14
ùàé	U+1D20E	[OtherSymbol]	GREEK VOCAL NOTATION SYMBOL-15
ùàè	U+1D20F	[OtherSymbol]	GREEK VOCAL NOTATION SYMBOL-16
ùàê	U+1D210	[OtherSymbol]	GREEK VOCAL NOTATION SYMBOL-17
ùàë	U+1D211	[OtherSymbol]	GREEK VOCAL NOTATION SYMBOL-18
ùàí	U+1D212	[OtherSymbol]	GREEK VOCAL NOTATION SYMBOL-19
ùàì	U+1D213	[OtherSymbol]	GREEK VOCAL NOTATION SYMBOL-20
ùàî	U+1D214	[OtherSymbol]	GREEK VOCAL NOTATION SYMBOL-21
ùàï	U+1D215	[OtherSymbol]	GREEK VOCAL NOTATION SYMBOL-22
ùàñ	U+1D216	[OtherSymbol]	GREEK VOCAL NOTATION SYMBOL-23
ùàó	U+1D217	[OtherSymbol]	GREEK VOCAL NOTATION SYMBOL-24
ùàò	U+1D218	[OtherSymbol]	GREEK VOCAL NOTATION SYMBOL-50
ùàô	U+1D219	[OtherSymbol]	GREEK VOCAL NOTATION SYMBOL-51
ùàö	U+1D21A	[OtherSymbol]	GREEK VOCAL NOTATION SYMBOL-52
ùàõ	U+1D21B	[OtherSymbol]	GREEK VOCAL NOTATION SYMBOL-53
ùàú	U+1D21C	[OtherSymbol]	GREEK VOCAL NOTATION SYMBOL-54
ùàù	U+1D21D	[OtherSymbol]	GREEK INSTRUMENTAL NOTATION SYMBOL-1
ùàû	U+1D21E	[OtherSymbol]	GREEK INSTRUMENTAL NOTATION SYMBOL-2
ùàü	U+1D21F	[OtherSymbol]	GREEK INSTRUMENTAL NOTATION SYMBOL-4
ùà†	U+1D220	[OtherSymbol]	GREEK INSTRUMENTAL NOTATION SYMBOL-5
ùà°	U+1D221	[OtherSymbol]	GREEK INSTRUMENTAL NOTATION SYMBOL-7
ùà¢	U+1D222	[OtherSymbol]	GREEK INSTRUMENTAL NOTATION SYMBOL-8
ùà£	U+1D223	[OtherSymbol]	GREEK INSTRUMENTAL NOTATION SYMBOL-11
ùà§	U+1D224	[OtherSymbol]	GREEK INSTRUMENTAL NOTATION SYMBOL-12
ùà•	U+1D225	[OtherSymbol]	GREEK INSTRUMENTAL NOTATION SYMBOL-13
ùà¶	U+1D226	[OtherSymbol]	GREEK INSTRUMENTAL NOTATION SYMBOL-14
ùàß	U+1D227	[OtherSymbol]	GREEK INSTRUMENTAL NOTATION SYMBOL-17
ùà®	U+1D228	[OtherSymbol]	GREEK INSTRUMENTAL NOTATION SYMBOL-18
ùà©	U+1D229	[OtherSymbol]	GREEK INSTRUMENTAL NOTATION SYMBOL-19
ùà™	U+1D22A	[OtherSymbol]	GREEK INSTRUMENTAL NOTATION SYMBOL-23
ùà´	U+1D22B	[OtherSymbol]	GREEK INSTRUMENTAL NOTATION SYMBOL-24
ùà¨	U+1D22C	[OtherSymbol]	GREEK INSTRUMENTAL NOTATION SYMBOL-25
ùà≠	U+1D22D	[OtherSymbol]	GREEK INSTRUMENTAL NOTATION SYMBOL-26
ùàÆ	U+1D22E	[OtherSymbol]	GREEK INSTRUMENTAL NOTATION SYMBOL-27
ùàØ	U+1D22F	[OtherSymbol]	GREEK INSTRUMENTAL NOTATION SYMBOL-29
ùà∞	U+1D230	[OtherSymbol]	GREEK INSTRUMENTAL NOTATION SYMBOL-30
ùà±	U+1D231	[OtherSymbol]	GREEK INSTRUMENTAL NOTATION SYMBOL-32
ùà≤	U+1D232	[OtherSymbol]	GREEK INSTRUMENTAL NOTATION SYMBOL-36
ùà≥	U+1D233	[OtherSymbol]	GREEK INSTRUMENTAL NOTATION SYMBOL-37
ùà¥	U+1D234	[OtherSymbol]	GREEK INSTRUMENTAL NOTATION SYMBOL-38
ùàµ	U+1D235	[OtherSymbol]	GREEK INSTRUMENTAL NOTATION SYMBOL-39
ùà∂	U+1D236	[OtherSymbol]	GREEK INSTRUMENTAL NOTATION SYMBOL-40
ùà∑	U+1D237	[OtherSymbol]	GREEK INSTRUMENTAL NOTATION SYMBOL-42
ùà∏	U+1D238	[OtherSymbol]	GREEK INSTRUMENTAL NOTATION SYMBOL-43
ùàπ	U+1D239	[OtherSymbol]	GREEK INSTRUMENTAL NOTATION SYMBOL-45
ùà∫	U+1D23A	[OtherSymbol]	GREEK INSTRUMENTAL NOTATION SYMBOL-47
ùàª	U+1D23B	[OtherSymbol]	GREEK INSTRUMENTAL NOTATION SYMBOL-48
ùàº	U+1D23C	[OtherSymbol]	GREEK INSTRUMENTAL NOTATION SYMBOL-49
ùàΩ	U+1D23D	[OtherSymbol]	GREEK INSTRUMENTAL NOTATION SYMBOL-50
ùàæ	U+1D23E	[OtherSymbol]	GREEK INSTRUMENTAL NOTATION SYMBOL-51
ùàø	U+1D23F	[OtherSymbol]	GREEK INSTRUMENTAL NOTATION SYMBOL-52
ùâÄ	U+1D240	[OtherSymbol]	GREEK INSTRUMENTAL NOTATION SYMBOL-53
ùâÅ	U+1D241	[OtherSymbol]	GREEK INSTRUMENTAL NOTATION SYMBOL-54
ùâÖ	U+1D245	[OtherSymbol]	GREEK MUSICAL LEIMMA

Õµ	U+375	[ModifierSymbol]	GREEK LOWER NUMERAL SIGN
ŒÑ	U+384	[ModifierSymbol]	GREEK TONOS
ŒÖ	U+385	[ModifierSymbol]	GREEK DIALYTIKA TONOS
·æΩ	U+1FBD	[ModifierSymbol]	GREEK KORONIS
·æø	U+1FBF	[ModifierSymbol]	GREEK PSILI
·øÄ	U+1FC0	[ModifierSymbol]	GREEK PERISPOMENI
·øÅ	U+1FC1	[ModifierSymbol]	GREEK DIALYTIKA AND PERISPOMENI
·øç	U+1FCD	[ModifierSymbol]	GREEK PSILI AND VARIA
·øé	U+1FCE	[ModifierSymbol]	GREEK PSILI AND OXIA
·øè	U+1FCF	[ModifierSymbol]	GREEK PSILI AND PERISPOMENI
·øù	U+1FDD	[ModifierSymbol]	GREEK DASIA AND VARIA
·øû	U+1FDE	[ModifierSymbol]	GREEK DASIA AND OXIA
·øü	U+1FDF	[ModifierSymbol]	GREEK DASIA AND PERISPOMENI
·ø≠	U+1FED	[ModifierSymbol]	GREEK DIALYTIKA AND VARIA
·øÆ	U+1FEE	[ModifierSymbol]	GREEK DIALYTIKA AND OXIA
·øØ	U+1FEF	[ModifierSymbol]	GREEK VARIA
·øΩ	U+1FFD	[ModifierSymbol]	GREEK OXIA
·øæ	U+1FFE	[ModifierSymbol]	GREEK DASIA

ÕÇ	U+342	[NonspacingMark]	COMBINING GREEK PERISPOMENI
ÕÉ	U+343	[NonspacingMark]	COMBINING GREEK KORONIS
ÕÑ	U+344	[NonspacingMark]	COMBINING GREEK DIALYTIKA TONOS
ÕÖ	U+345	[NonspacingMark]	COMBINING GREEK YPOGEGRAMMENI
ùâÇ	U+1D242	[NonspacingMark]	COMBINING GREEK MUSICAL TRISEME
ùâÉ	U+1D243	[NonspacingMark]	COMBINING GREEK MUSICAL TETRASEME
ùâÑ	U+1D244	[NonspacingMark]	COMBINING GREEK MUSICAL PENTASEME

Õ∞	U+370	[UppercaseLetter]	GREEK CAPITAL LETTER HETA
Õ≤	U+372	[UppercaseLetter]	GREEK CAPITAL LETTER ARCHAIC SAMPI
Õ∂	U+376	[UppercaseLetter]	GREEK CAPITAL LETTER PAMPHYLIAN DIGAMMA
ŒÜ	U+386	[UppercaseLetter]	GREEK CAPITAL LETTER ALPHA WITH TONOS
Œà	U+388	[UppercaseLetter]	GREEK CAPITAL LETTER EPSILON WITH TONOS
Œâ	U+389	[UppercaseLetter]	GREEK CAPITAL LETTER ETA WITH TONOS
Œä	U+38A	[UppercaseLetter]	GREEK CAPITAL LETTER IOTA WITH TONOS
Œå	U+38C	[UppercaseLetter]	GREEK CAPITAL LETTER OMICRON WITH TONOS
Œé	U+38E	[UppercaseLetter]	GREEK CAPITAL LETTER UPSILON WITH TONOS
Œè	U+38F	[UppercaseLetter]	GREEK CAPITAL LETTER OMEGA WITH TONOS
Œë	U+391	[UppercaseLetter]	GREEK CAPITAL LETTER ALPHA
Œí	U+392	[UppercaseLetter]	GREEK CAPITAL LETTER BETA
Œì	U+393	[UppercaseLetter]	GREEK CAPITAL LETTER GAMMA
Œî	U+394	[UppercaseLetter]	GREEK CAPITAL LETTER DELTA
Œï	U+395	[UppercaseLetter]	GREEK CAPITAL LETTER EPSILON
Œñ	U+396	[UppercaseLetter]	GREEK CAPITAL LETTER ZETA
Œó	U+397	[UppercaseLetter]	GREEK CAPITAL LETTER ETA
Œò	U+398	[UppercaseLetter]	GREEK CAPITAL LETTER THETA
Œô	U+399	[UppercaseLetter]	GREEK CAPITAL LETTER IOTA
Œö	U+39A	[UppercaseLetter]	GREEK CAPITAL LETTER KAPPA
Œõ	U+39B	[UppercaseLetter]	GREEK CAPITAL LETTER LAMDA
Œú	U+39C	[UppercaseLetter]	GREEK CAPITAL LETTER MU
Œù	U+39D	[UppercaseLetter]	GREEK CAPITAL LETTER NU
Œû	U+39E	[UppercaseLetter]	GREEK CAPITAL LETTER XI
Œü	U+39F	[UppercaseLetter]	GREEK CAPITAL LETTER OMICRON
Œ†	U+3A0	[UppercaseLetter]	GREEK CAPITAL LETTER PI
Œ°	U+3A1	[UppercaseLetter]	GREEK CAPITAL LETTER RHO
Œ£	U+3A3	[UppercaseLetter]	GREEK CAPITAL LETTER SIGMA
Œ§	U+3A4	[UppercaseLetter]	GREEK CAPITAL LETTER TAU
Œ•	U+3A5	[UppercaseLetter]	GREEK CAPITAL LETTER UPSILON
Œ¶	U+3A6	[UppercaseLetter]	GREEK CAPITAL LETTER PHI
Œß	U+3A7	[UppercaseLetter]	GREEK CAPITAL LETTER CHI
Œ®	U+3A8	[UppercaseLetter]	GREEK CAPITAL LETTER PSI
Œ©	U+3A9	[UppercaseLetter]	GREEK CAPITAL LETTER OMEGA
Œ™	U+3AA	[UppercaseLetter]	GREEK CAPITAL LETTER IOTA WITH DIALYTIKA
Œ´	U+3AB	[UppercaseLetter]	GREEK CAPITAL LETTER UPSILON WITH DIALYTIKA
œè	U+3CF	[UppercaseLetter]	GREEK CAPITAL KAI SYMBOL
œí	U+3D2	[UppercaseLetter]	GREEK UPSILON WITH HOOK SYMBOL
œì	U+3D3	[UppercaseLetter]	GREEK UPSILON WITH ACUTE AND HOOK SYMBOL
œî	U+3D4	[UppercaseLetter]	GREEK UPSILON WITH DIAERESIS AND HOOK SYMBOL
œò	U+3D8	[UppercaseLetter]	GREEK LETTER ARCHAIC KOPPA
œö	U+3DA	[UppercaseLetter]	GREEK LETTER STIGMA
œú	U+3DC	[UppercaseLetter]	GREEK LETTER DIGAMMA
œû	U+3DE	[UppercaseLetter]	GREEK LETTER KOPPA
œ†	U+3E0	[UppercaseLetter]	GREEK LETTER SAMPI
œ¥	U+3F4	[UppercaseLetter]	GREEK CAPITAL THETA SYMBOL
œ∑	U+3F7	[UppercaseLetter]	GREEK CAPITAL LETTER SHO
œπ	U+3F9	[UppercaseLetter]	GREEK CAPITAL LUNATE SIGMA SYMBOL
œ∫	U+3FA	[UppercaseLetter]	GREEK CAPITAL LETTER SAN
œΩ	U+3FD	[UppercaseLetter]	GREEK CAPITAL REVERSED LUNATE SIGMA SYMBOL
œæ	U+3FE	[UppercaseLetter]	GREEK CAPITAL DOTTED LUNATE SIGMA SYMBOL
œø	U+3FF	[UppercaseLetter]	GREEK CAPITAL REVERSED DOTTED LUNATE SIGMA SYMBOL
·ºà	U+1F08	[UppercaseLetter]	GREEK CAPITAL LETTER ALPHA WITH PSILI
·ºâ	U+1F09	[UppercaseLetter]	GREEK CAPITAL LETTER ALPHA WITH DASIA
·ºä	U+1F0A	[UppercaseLetter]	GREEK CAPITAL LETTER ALPHA WITH PSILI AND VARIA
·ºã	U+1F0B	[UppercaseLetter]	GREEK CAPITAL LETTER ALPHA WITH DASIA AND VARIA
·ºå	U+1F0C	[UppercaseLetter]	GREEK CAPITAL LETTER ALPHA WITH PSILI AND OXIA
·ºç	U+1F0D	[UppercaseLetter]	GREEK CAPITAL LETTER ALPHA WITH DASIA AND OXIA
·ºé	U+1F0E	[UppercaseLetter]	GREEK CAPITAL LETTER ALPHA WITH PSILI AND PERISPOMENI
·ºè	U+1F0F	[UppercaseLetter]	GREEK CAPITAL LETTER ALPHA WITH DASIA AND PERISPOMENI
·ºò	U+1F18	[UppercaseLetter]	GREEK CAPITAL LETTER EPSILON WITH PSILI
·ºô	U+1F19	[UppercaseLetter]	GREEK CAPITAL LETTER EPSILON WITH DASIA
·ºö	U+1F1A	[UppercaseLetter]	GREEK CAPITAL LETTER EPSILON WITH PSILI AND VARIA
·ºõ	U+1F1B	[UppercaseLetter]	GREEK CAPITAL LETTER EPSILON WITH DASIA AND VARIA
·ºú	U+1F1C	[UppercaseLetter]	GREEK CAPITAL LETTER EPSILON WITH PSILI AND OXIA
·ºù	U+1F1D	[UppercaseLetter]	GREEK CAPITAL LETTER EPSILON WITH DASIA AND OXIA
·º®	U+1F28	[UppercaseLetter]	GREEK CAPITAL LETTER ETA WITH PSILI
·º©	U+1F29	[UppercaseLetter]	GREEK CAPITAL LETTER ETA WITH DASIA
·º™	U+1F2A	[UppercaseLetter]	GREEK CAPITAL LETTER ETA WITH PSILI AND VARIA
·º´	U+1F2B	[UppercaseLetter]	GREEK CAPITAL LETTER ETA WITH DASIA AND VARIA
·º¨	U+1F2C	[UppercaseLetter]	GREEK CAPITAL LETTER ETA WITH PSILI AND OXIA
·º≠	U+1F2D	[UppercaseLetter]	GREEK CAPITAL LETTER ETA WITH DASIA AND OXIA
·ºÆ	U+1F2E	[UppercaseLetter]	GREEK CAPITAL LETTER ETA WITH PSILI AND PERISPOMENI
·ºØ	U+1F2F	[UppercaseLetter]	GREEK CAPITAL LETTER ETA WITH DASIA AND PERISPOMENI
·º∏	U+1F38	[UppercaseLetter]	GREEK CAPITAL LETTER IOTA WITH PSILI
·ºπ	U+1F39	[UppercaseLetter]	GREEK CAPITAL LETTER IOTA WITH DASIA
·º∫	U+1F3A	[UppercaseLetter]	GREEK CAPITAL LETTER IOTA WITH PSILI AND VARIA
·ºª	U+1F3B	[UppercaseLetter]	GREEK CAPITAL LETTER IOTA WITH DASIA AND VARIA
·ºº	U+1F3C	[UppercaseLetter]	GREEK CAPITAL LETTER IOTA WITH PSILI AND OXIA
·ºΩ	U+1F3D	[UppercaseLetter]	GREEK CAPITAL LETTER IOTA WITH DASIA AND OXIA
·ºæ	U+1F3E	[UppercaseLetter]	GREEK CAPITAL LETTER IOTA WITH PSILI AND PERISPOMENI
·ºø	U+1F3F	[UppercaseLetter]	GREEK CAPITAL LETTER IOTA WITH DASIA AND PERISPOMENI
·Ωà	U+1F48	[UppercaseLetter]	GREEK CAPITAL LETTER OMICRON WITH PSILI
·Ωâ	U+1F49	[UppercaseLetter]	GREEK CAPITAL LETTER OMICRON WITH DASIA
·Ωä	U+1F4A	[UppercaseLetter]	GREEK CAPITAL LETTER OMICRON WITH PSILI AND VARIA
·Ωã	U+1F4B	[UppercaseLetter]	GREEK CAPITAL LETTER OMICRON WITH DASIA AND VARIA
·Ωå	U+1F4C	[UppercaseLetter]	GREEK CAPITAL LETTER OMICRON WITH PSILI AND OXIA
·Ωç	U+1F4D	[UppercaseLetter]	GREEK CAPITAL LETTER OMICRON WITH DASIA AND OXIA
·Ωô	U+1F59	[UppercaseLetter]	GREEK CAPITAL LETTER UPSILON WITH DASIA
·Ωõ	U+1F5B	[UppercaseLetter]	GREEK CAPITAL LETTER UPSILON WITH DASIA AND VARIA
·Ωù	U+1F5D	[UppercaseLetter]	GREEK CAPITAL LETTER UPSILON WITH DASIA AND OXIA
·Ωü	U+1F5F	[UppercaseLetter]	GREEK CAPITAL LETTER UPSILON WITH DASIA AND PERISPOMENI
·Ω®	U+1F68	[UppercaseLetter]	GREEK CAPITAL LETTER OMEGA WITH PSILI
·Ω©	U+1F69	[UppercaseLetter]	GREEK CAPITAL LETTER OMEGA WITH DASIA
·Ω™	U+1F6A	[UppercaseLetter]	GREEK CAPITAL LETTER OMEGA WITH PSILI AND VARIA
·Ω´	U+1F6B	[UppercaseLetter]	GREEK CAPITAL LETTER OMEGA WITH DASIA AND VARIA
·Ω¨	U+1F6C	[UppercaseLetter]	GREEK CAPITAL LETTER OMEGA WITH PSILI AND OXIA
·Ω≠	U+1F6D	[UppercaseLetter]	GREEK CAPITAL LETTER OMEGA WITH DASIA AND OXIA
·ΩÆ	U+1F6E	[UppercaseLetter]	GREEK CAPITAL LETTER OMEGA WITH PSILI AND PERISPOMENI
·ΩØ	U+1F6F	[UppercaseLetter]	GREEK CAPITAL LETTER OMEGA WITH DASIA AND PERISPOMENI
·æ∏	U+1FB8	[UppercaseLetter]	GREEK CAPITAL LETTER ALPHA WITH VRACHY
·æπ	U+1FB9	[UppercaseLetter]	GREEK CAPITAL LETTER ALPHA WITH MACRON
·æ∫	U+1FBA	[UppercaseLetter]	GREEK CAPITAL LETTER ALPHA WITH VARIA
·æª	U+1FBB	[UppercaseLetter]	GREEK CAPITAL LETTER ALPHA WITH OXIA
·øà	U+1FC8	[UppercaseLetter]	GREEK CAPITAL LETTER EPSILON WITH VARIA
·øâ	U+1FC9	[UppercaseLetter]	GREEK CAPITAL LETTER EPSILON WITH OXIA
·øä	U+1FCA	[UppercaseLetter]	GREEK CAPITAL LETTER ETA WITH VARIA
·øã	U+1FCB	[UppercaseLetter]	GREEK CAPITAL LETTER ETA WITH OXIA
·øò	U+1FD8	[UppercaseLetter]	GREEK CAPITAL LETTER IOTA WITH VRACHY
·øô	U+1FD9	[UppercaseLetter]	GREEK CAPITAL LETTER IOTA WITH MACRON
·øö	U+1FDA	[UppercaseLetter]	GREEK CAPITAL LETTER IOTA WITH VARIA
·øõ	U+1FDB	[UppercaseLetter]	GREEK CAPITAL LETTER IOTA WITH OXIA
·ø®	U+1FE8	[UppercaseLetter]	GREEK CAPITAL LETTER UPSILON WITH VRACHY
·ø©	U+1FE9	[UppercaseLetter]	GREEK CAPITAL LETTER UPSILON WITH MACRON
·ø™	U+1FEA	[UppercaseLetter]	GREEK CAPITAL LETTER UPSILON WITH VARIA
·ø´	U+1FEB	[UppercaseLetter]	GREEK CAPITAL LETTER UPSILON WITH OXIA
·ø¨	U+1FEC	[UppercaseLetter]	GREEK CAPITAL LETTER RHO WITH DASIA
·ø∏	U+1FF8	[UppercaseLetter]	GREEK CAPITAL LETTER OMICRON WITH VARIA
·øπ	U+1FF9	[UppercaseLetter]	GREEK CAPITAL LETTER OMICRON WITH OXIA
·ø∫	U+1FFA	[UppercaseLetter]	GREEK CAPITAL LETTER OMEGA WITH VARIA
·øª	U+1FFB	[UppercaseLetter]	GREEK CAPITAL LETTER OMEGA WITH OXIA

·æà	U+1F88	[TitlecaseLetter]	GREEK CAPITAL LETTER ALPHA WITH PSILI AND PROSGEGRAMMENI
·æâ	U+1F89	[TitlecaseLetter]	GREEK CAPITAL LETTER ALPHA WITH DASIA AND PROSGEGRAMMENI
·æä	U+1F8A	[TitlecaseLetter]	GREEK CAPITAL LETTER ALPHA WITH PSILI AND VARIA AND PROSGEGRAMMENI
·æã	U+1F8B	[TitlecaseLetter]	GREEK CAPITAL LETTER ALPHA WITH DASIA AND VARIA AND PROSGEGRAMMENI
·æå	U+1F8C	[TitlecaseLetter]	GREEK CAPITAL LETTER ALPHA WITH PSILI AND OXIA AND PROSGEGRAMMENI
·æç	U+1F8D	[TitlecaseLetter]	GREEK CAPITAL LETTER ALPHA WITH DASIA AND OXIA AND PROSGEGRAMMENI
·æé	U+1F8E	[TitlecaseLetter]	GREEK CAPITAL LETTER ALPHA WITH PSILI AND PERISPOMENI AND PROSGEGRAMMENI
·æè	U+1F8F	[TitlecaseLetter]	GREEK CAPITAL LETTER ALPHA WITH DASIA AND PERISPOMENI AND PROSGEGRAMMENI
·æò	U+1F98	[TitlecaseLetter]	GREEK CAPITAL LETTER ETA WITH PSILI AND PROSGEGRAMMENI
·æô	U+1F99	[TitlecaseLetter]	GREEK CAPITAL LETTER ETA WITH DASIA AND PROSGEGRAMMENI
·æö	U+1F9A	[TitlecaseLetter]	GREEK CAPITAL LETTER ETA WITH PSILI AND VARIA AND PROSGEGRAMMENI
·æõ	U+1F9B	[TitlecaseLetter]	GREEK CAPITAL LETTER ETA WITH DASIA AND VARIA AND PROSGEGRAMMENI
·æú	U+1F9C	[TitlecaseLetter]	GREEK CAPITAL LETTER ETA WITH PSILI AND OXIA AND PROSGEGRAMMENI
·æù	U+1F9D	[TitlecaseLetter]	GREEK CAPITAL LETTER ETA WITH DASIA AND OXIA AND PROSGEGRAMMENI
·æû	U+1F9E	[TitlecaseLetter]	GREEK CAPITAL LETTER ETA WITH PSILI AND PERISPOMENI AND PROSGEGRAMMENI
·æü	U+1F9F	[TitlecaseLetter]	GREEK CAPITAL LETTER ETA WITH DASIA AND PERISPOMENI AND PROSGEGRAMMENI
·æ®	U+1FA8	[TitlecaseLetter]	GREEK CAPITAL LETTER OMEGA WITH PSILI AND PROSGEGRAMMENI
·æ©	U+1FA9	[TitlecaseLetter]	GREEK CAPITAL LETTER OMEGA WITH DASIA AND PROSGEGRAMMENI
·æ™	U+1FAA	[TitlecaseLetter]	GREEK CAPITAL LETTER OMEGA WITH PSILI AND VARIA AND PROSGEGRAMMENI
·æ´	U+1FAB	[TitlecaseLetter]	GREEK CAPITAL LETTER OMEGA WITH DASIA AND VARIA AND PROSGEGRAMMENI
·æ¨	U+1FAC	[TitlecaseLetter]	GREEK CAPITAL LETTER OMEGA WITH PSILI AND OXIA AND PROSGEGRAMMENI
·æ≠	U+1FAD	[TitlecaseLetter]	GREEK CAPITAL LETTER OMEGA WITH DASIA AND OXIA AND PROSGEGRAMMENI
·æÆ	U+1FAE	[TitlecaseLetter]	GREEK CAPITAL LETTER OMEGA WITH PSILI AND PERISPOMENI AND PROSGEGRAMMENI
·æØ	U+1FAF	[TitlecaseLetter]	GREEK CAPITAL LETTER OMEGA WITH DASIA AND PERISPOMENI AND PROSGEGRAMMENI
·æº	U+1FBC	[TitlecaseLetter]	GREEK CAPITAL LETTER ALPHA WITH PROSGEGRAMMENI
·øå	U+1FCC	[TitlecaseLetter]	GREEK CAPITAL LETTER ETA WITH PROSGEGRAMMENI
·øº	U+1FFC	[TitlecaseLetter]	GREEK CAPITAL LETTER OMEGA WITH PROSGEGRAMMENI

Õ±	U+371	[LowercaseLetter]	GREEK SMALL LETTER HETA
Õ≥	U+373	[LowercaseLetter]	GREEK SMALL LETTER ARCHAIC SAMPI
Õ∑	U+377	[LowercaseLetter]	GREEK SMALL LETTER PAMPHYLIAN DIGAMMA
Õª	U+37B	[LowercaseLetter]	GREEK SMALL REVERSED LUNATE SIGMA SYMBOL
Õº	U+37C	[LowercaseLetter]	GREEK SMALL DOTTED LUNATE SIGMA SYMBOL
ÕΩ	U+37D	[LowercaseLetter]	GREEK SMALL REVERSED DOTTED LUNATE SIGMA SYMBOL
Œê	U+390	[LowercaseLetter]	GREEK SMALL LETTER IOTA WITH DIALYTIKA AND TONOS
Œ¨	U+3AC	[LowercaseLetter]	GREEK SMALL LETTER ALPHA WITH TONOS
Œ≠	U+3AD	[LowercaseLetter]	GREEK SMALL LETTER EPSILON WITH TONOS
ŒÆ	U+3AE	[LowercaseLetter]	GREEK SMALL LETTER ETA WITH TONOS
ŒØ	U+3AF	[LowercaseLetter]	GREEK SMALL LETTER IOTA WITH TONOS
Œ∞	U+3B0	[LowercaseLetter]	GREEK SMALL LETTER UPSILON WITH DIALYTIKA AND TONOS
Œ±	U+3B1	[LowercaseLetter]	GREEK SMALL LETTER ALPHA
Œ≤	U+3B2	[LowercaseLetter]	GREEK SMALL LETTER BETA
Œ≥	U+3B3	[LowercaseLetter]	GREEK SMALL LETTER GAMMA
Œ¥	U+3B4	[LowercaseLetter]	GREEK SMALL LETTER DELTA
Œµ	U+3B5	[LowercaseLetter]	GREEK SMALL LETTER EPSILON
Œ∂	U+3B6	[LowercaseLetter]	GREEK SMALL LETTER ZETA
Œ∑	U+3B7	[LowercaseLetter]	GREEK SMALL LETTER ETA
Œ∏	U+3B8	[LowercaseLetter]	GREEK SMALL LETTER THETA
Œπ	U+3B9	[LowercaseLetter]	GREEK SMALL LETTER IOTA
Œ∫	U+3BA	[LowercaseLetter]	GREEK SMALL LETTER KAPPA
Œª	U+3BB	[LowercaseLetter]	GREEK SMALL LETTER LAMDA
Œº	U+3BC	[LowercaseLetter]	GREEK SMALL LETTER MU
ŒΩ	U+3BD	[LowercaseLetter]	GREEK SMALL LETTER NU
Œæ	U+3BE	[LowercaseLetter]	GREEK SMALL LETTER XI
Œø	U+3BF	[LowercaseLetter]	GREEK SMALL LETTER OMICRON
œÄ	U+3C0	[LowercaseLetter]	GREEK SMALL LETTER PI
œÅ	U+3C1	[LowercaseLetter]	GREEK SMALL LETTER RHO
œÇ	U+3C2	[LowercaseLetter]	GREEK SMALL LETTER FINAL SIGMA
œÉ	U+3C3	[LowercaseLetter]	GREEK SMALL LETTER SIGMA
œÑ	U+3C4	[LowercaseLetter]	GREEK SMALL LETTER TAU
œÖ	U+3C5	[LowercaseLetter]	GREEK SMALL LETTER UPSILON
œÜ	U+3C6	[LowercaseLetter]	GREEK SMALL LETTER PHI
œá	U+3C7	[LowercaseLetter]	GREEK SMALL LETTER CHI
œà	U+3C8	[LowercaseLetter]	GREEK SMALL LETTER PSI
œâ	U+3C9	[LowercaseLetter]	GREEK SMALL LETTER OMEGA
œä	U+3CA	[LowercaseLetter]	GREEK SMALL LETTER IOTA WITH DIALYTIKA
œã	U+3CB	[LowercaseLetter]	GREEK SMALL LETTER UPSILON WITH DIALYTIKA
œå	U+3CC	[LowercaseLetter]	GREEK SMALL LETTER OMICRON WITH TONOS
œç	U+3CD	[LowercaseLetter]	GREEK SMALL LETTER UPSILON WITH TONOS
œé	U+3CE	[LowercaseLetter]	GREEK SMALL LETTER OMEGA WITH TONOS
œê	U+3D0	[LowercaseLetter]	GREEK BETA SYMBOL
œë	U+3D1	[LowercaseLetter]	GREEK THETA SYMBOL
œï	U+3D5	[LowercaseLetter]	GREEK PHI SYMBOL
œñ	U+3D6	[LowercaseLetter]	GREEK PI SYMBOL
œó	U+3D7	[LowercaseLetter]	GREEK KAI SYMBOL
œô	U+3D9	[LowercaseLetter]	GREEK SMALL LETTER ARCHAIC KOPPA
œõ	U+3DB	[LowercaseLetter]	GREEK SMALL LETTER STIGMA
œù	U+3DD	[LowercaseLetter]	GREEK SMALL LETTER DIGAMMA
œü	U+3DF	[LowercaseLetter]	GREEK SMALL LETTER KOPPA
œ°	U+3E1	[LowercaseLetter]	GREEK SMALL LETTER SAMPI
œ∞	U+3F0	[LowercaseLetter]	GREEK KAPPA SYMBOL
œ±	U+3F1	[LowercaseLetter]	GREEK RHO SYMBOL
œ≤	U+3F2	[LowercaseLetter]	GREEK LUNATE SIGMA SYMBOL
œ≥	U+3F3	[LowercaseLetter]	GREEK LETTER YOT
œµ	U+3F5	[LowercaseLetter]	GREEK LUNATE EPSILON SYMBOL
œ∏	U+3F8	[LowercaseLetter]	GREEK SMALL LETTER SHO
œª	U+3FB	[LowercaseLetter]	GREEK SMALL LETTER SAN
œº	U+3FC	[LowercaseLetter]	GREEK RHO WITH STROKE SYMBOL
·¥¶	U+1D26	[LowercaseLetter]	GREEK LETTER SMALL CAPITAL GAMMA
·¥ß	U+1D27	[LowercaseLetter]	GREEK LETTER SMALL CAPITAL LAMDA
·¥®	U+1D28	[LowercaseLetter]	GREEK LETTER SMALL CAPITAL PI
·¥©	U+1D29	[LowercaseLetter]	GREEK LETTER SMALL CAPITAL RHO
·¥™	U+1D2A	[LowercaseLetter]	GREEK LETTER SMALL CAPITAL PSI
·ºÄ	U+1F00	[LowercaseLetter]	GREEK SMALL LETTER ALPHA WITH PSILI
·ºÅ	U+1F01	[LowercaseLetter]	GREEK SMALL LETTER ALPHA WITH DASIA
·ºÇ	U+1F02	[LowercaseLetter]	GREEK SMALL LETTER ALPHA WITH PSILI AND VARIA
·ºÉ	U+1F03	[LowercaseLetter]	GREEK SMALL LETTER ALPHA WITH DASIA AND VARIA
·ºÑ	U+1F04	[LowercaseLetter]	GREEK SMALL LETTER ALPHA WITH PSILI AND OXIA
·ºÖ	U+1F05	[LowercaseLetter]	GREEK SMALL LETTER ALPHA WITH DASIA AND OXIA
·ºÜ	U+1F06	[LowercaseLetter]	GREEK SMALL LETTER ALPHA WITH PSILI AND PERISPOMENI
·ºá	U+1F07	[LowercaseLetter]	GREEK SMALL LETTER ALPHA WITH DASIA AND PERISPOMENI
·ºê	U+1F10	[LowercaseLetter]	GREEK SMALL LETTER EPSILON WITH PSILI
·ºë	U+1F11	[LowercaseLetter]	GREEK SMALL LETTER EPSILON WITH DASIA
·ºí	U+1F12	[LowercaseLetter]	GREEK SMALL LETTER EPSILON WITH PSILI AND VARIA
·ºì	U+1F13	[LowercaseLetter]	GREEK SMALL LETTER EPSILON WITH DASIA AND VARIA
·ºî	U+1F14	[LowercaseLetter]	GREEK SMALL LETTER EPSILON WITH PSILI AND OXIA
·ºï	U+1F15	[LowercaseLetter]	GREEK SMALL LETTER EPSILON WITH DASIA AND OXIA
·º†	U+1F20	[LowercaseLetter]	GREEK SMALL LETTER ETA WITH PSILI
·º°	U+1F21	[LowercaseLetter]	GREEK SMALL LETTER ETA WITH DASIA
·º¢	U+1F22	[LowercaseLetter]	GREEK SMALL LETTER ETA WITH PSILI AND VARIA
·º£	U+1F23	[LowercaseLetter]	GREEK SMALL LETTER ETA WITH DASIA AND VARIA
·º§	U+1F24	[LowercaseLetter]	GREEK SMALL LETTER ETA WITH PSILI AND OXIA
·º•	U+1F25	[LowercaseLetter]	GREEK SMALL LETTER ETA WITH DASIA AND OXIA
·º¶	U+1F26	[LowercaseLetter]	GREEK SMALL LETTER ETA WITH PSILI AND PERISPOMENI
·ºß	U+1F27	[LowercaseLetter]	GREEK SMALL LETTER ETA WITH DASIA AND PERISPOMENI
·º∞	U+1F30	[LowercaseLetter]	GREEK SMALL LETTER IOTA WITH PSILI
·º±	U+1F31	[LowercaseLetter]	GREEK SMALL LETTER IOTA WITH DASIA
·º≤	U+1F32	[LowercaseLetter]	GREEK SMALL LETTER IOTA WITH PSILI AND VARIA
·º≥	U+1F33	[LowercaseLetter]	GREEK SMALL LETTER IOTA WITH DASIA AND VARIA
·º¥	U+1F34	[LowercaseLetter]	GREEK SMALL LETTER IOTA WITH PSILI AND OXIA
·ºµ	U+1F35	[LowercaseLetter]	GREEK SMALL LETTER IOTA WITH DASIA AND OXIA
·º∂	U+1F36	[LowercaseLetter]	GREEK SMALL LETTER IOTA WITH PSILI AND PERISPOMENI
·º∑	U+1F37	[LowercaseLetter]	GREEK SMALL LETTER IOTA WITH DASIA AND PERISPOMENI
·ΩÄ	U+1F40	[LowercaseLetter]	GREEK SMALL LETTER OMICRON WITH PSILI
·ΩÅ	U+1F41	[LowercaseLetter]	GREEK SMALL LETTER OMICRON WITH DASIA
·ΩÇ	U+1F42	[LowercaseLetter]	GREEK SMALL LETTER OMICRON WITH PSILI AND VARIA
·ΩÉ	U+1F43	[LowercaseLetter]	GREEK SMALL LETTER OMICRON WITH DASIA AND VARIA
·ΩÑ	U+1F44	[LowercaseLetter]	GREEK SMALL LETTER OMICRON WITH PSILI AND OXIA
·ΩÖ	U+1F45	[LowercaseLetter]	GREEK SMALL LETTER OMICRON WITH DASIA AND OXIA
·Ωê	U+1F50	[LowercaseLetter]	GREEK SMALL LETTER UPSILON WITH PSILI
·Ωë	U+1F51	[LowercaseLetter]	GREEK SMALL LETTER UPSILON WITH DASIA
·Ωí	U+1F52	[LowercaseLetter]	GREEK SMALL LETTER UPSILON WITH PSILI AND VARIA
·Ωì	U+1F53	[LowercaseLetter]	GREEK SMALL LETTER UPSILON WITH DASIA AND VARIA
·Ωî	U+1F54	[LowercaseLetter]	GREEK SMALL LETTER UPSILON WITH PSILI AND OXIA
·Ωï	U+1F55	[LowercaseLetter]	GREEK SMALL LETTER UPSILON WITH DASIA AND OXIA
·Ωñ	U+1F56	[LowercaseLetter]	GREEK SMALL LETTER UPSILON WITH PSILI AND PERISPOMENI
·Ωó	U+1F57	[LowercaseLetter]	GREEK SMALL LETTER UPSILON WITH DASIA AND PERISPOMENI
·Ω†	U+1F60	[LowercaseLetter]	GREEK SMALL LETTER OMEGA WITH PSILI
·Ω°	U+1F61	[LowercaseLetter]	GREEK SMALL LETTER OMEGA WITH DASIA
·Ω¢	U+1F62	[LowercaseLetter]	GREEK SMALL LETTER OMEGA WITH PSILI AND VARIA
·Ω£	U+1F63	[LowercaseLetter]	GREEK SMALL LETTER OMEGA WITH DASIA AND VARIA
·Ω§	U+1F64	[LowercaseLetter]	GREEK SMALL LETTER OMEGA WITH PSILI AND OXIA
·Ω•	U+1F65	[LowercaseLetter]	GREEK SMALL LETTER OMEGA WITH DASIA AND OXIA
·Ω¶	U+1F66	[LowercaseLetter]	GREEK SMALL LETTER OMEGA WITH PSILI AND PERISPOMENI
·Ωß	U+1F67	[LowercaseLetter]	GREEK SMALL LETTER OMEGA WITH DASIA AND PERISPOMENI
·Ω∞	U+1F70	[LowercaseLetter]	GREEK SMALL LETTER ALPHA WITH VARIA
·Ω±	U+1F71	[LowercaseLetter]	GREEK SMALL LETTER ALPHA WITH OXIA
·Ω≤	U+1F72	[LowercaseLetter]	GREEK SMALL LETTER EPSILON WITH VARIA
·Ω≥	U+1F73	[LowercaseLetter]	GREEK SMALL LETTER EPSILON WITH OXIA
·Ω¥	U+1F74	[LowercaseLetter]	GREEK SMALL LETTER ETA WITH VARIA
·Ωµ	U+1F75	[LowercaseLetter]	GREEK SMALL LETTER ETA WITH OXIA
·Ω∂	U+1F76	[LowercaseLetter]	GREEK SMALL LETTER IOTA WITH VARIA
·Ω∑	U+1F77	[LowercaseLetter]	GREEK SMALL LETTER IOTA WITH OXIA
·Ω∏	U+1F78	[LowercaseLetter]	GREEK SMALL LETTER OMICRON WITH VARIA
·Ωπ	U+1F79	[LowercaseLetter]	GREEK SMALL LETTER OMICRON WITH OXIA
·Ω∫	U+1F7A	[LowercaseLetter]	GREEK SMALL LETTER UPSILON WITH VARIA
·Ωª	U+1F7B	[LowercaseLetter]	GREEK SMALL LETTER UPSILON WITH OXIA
·Ωº	U+1F7C	[LowercaseLetter]	GREEK SMALL LETTER OMEGA WITH VARIA
·ΩΩ	U+1F7D	[LowercaseLetter]	GREEK SMALL LETTER OMEGA WITH OXIA
·æÄ	U+1F80	[LowercaseLetter]	GREEK SMALL LETTER ALPHA WITH PSILI AND YPOGEGRAMMENI
·æÅ	U+1F81	[LowercaseLetter]	GREEK SMALL LETTER ALPHA WITH DASIA AND YPOGEGRAMMENI
·æÇ	U+1F82	[LowercaseLetter]	GREEK SMALL LETTER ALPHA WITH PSILI AND VARIA AND YPOGEGRAMMENI
·æÉ	U+1F83	[LowercaseLetter]	GREEK SMALL LETTER ALPHA WITH DASIA AND VARIA AND YPOGEGRAMMENI
·æÑ	U+1F84	[LowercaseLetter]	GREEK SMALL LETTER ALPHA WITH PSILI AND OXIA AND YPOGEGRAMMENI
·æÖ	U+1F85	[LowercaseLetter]	GREEK SMALL LETTER ALPHA WITH DASIA AND OXIA AND YPOGEGRAMMENI
·æÜ	U+1F86	[LowercaseLetter]	GREEK SMALL LETTER ALPHA WITH PSILI AND PERISPOMENI AND YPOGEGRAMMENI
·æá	U+1F87	[LowercaseLetter]	GREEK SMALL LETTER ALPHA WITH DASIA AND PERISPOMENI AND YPOGEGRAMMENI
·æê	U+1F90	[LowercaseLetter]	GREEK SMALL LETTER ETA WITH PSILI AND YPOGEGRAMMENI
·æë	U+1F91	[LowercaseLetter]	GREEK SMALL LETTER ETA WITH DASIA AND YPOGEGRAMMENI
·æí	U+1F92	[LowercaseLetter]	GREEK SMALL LETTER ETA WITH PSILI AND VARIA AND YPOGEGRAMMENI
·æì	U+1F93	[LowercaseLetter]	GREEK SMALL LETTER ETA WITH DASIA AND VARIA AND YPOGEGRAMMENI
·æî	U+1F94	[LowercaseLetter]	GREEK SMALL LETTER ETA WITH PSILI AND OXIA AND YPOGEGRAMMENI
·æï	U+1F95	[LowercaseLetter]	GREEK SMALL LETTER ETA WITH DASIA AND OXIA AND YPOGEGRAMMENI
·æñ	U+1F96	[LowercaseLetter]	GREEK SMALL LETTER ETA WITH PSILI AND PERISPOMENI AND YPOGEGRAMMENI
·æó	U+1F97	[LowercaseLetter]	GREEK SMALL LETTER ETA WITH DASIA AND PERISPOMENI AND YPOGEGRAMMENI
·æ†	U+1FA0	[LowercaseLetter]	GREEK SMALL LETTER OMEGA WITH PSILI AND YPOGEGRAMMENI
·æ°	U+1FA1	[LowercaseLetter]	GREEK SMALL LETTER OMEGA WITH DASIA AND YPOGEGRAMMENI
·æ¢	U+1FA2	[LowercaseLetter]	GREEK SMALL LETTER OMEGA WITH PSILI AND VARIA AND YPOGEGRAMMENI
·æ£	U+1FA3	[LowercaseLetter]	GREEK SMALL LETTER OMEGA WITH DASIA AND VARIA AND YPOGEGRAMMENI
·æ§	U+1FA4	[LowercaseLetter]	GREEK SMALL LETTER OMEGA WITH PSILI AND OXIA AND YPOGEGRAMMENI
·æ•	U+1FA5	[LowercaseLetter]	GREEK SMALL LETTER OMEGA WITH DASIA AND OXIA AND YPOGEGRAMMENI
·æ¶	U+1FA6	[LowercaseLetter]	GREEK SMALL LETTER OMEGA WITH PSILI AND PERISPOMENI AND YPOGEGRAMMENI
·æß	U+1FA7	[LowercaseLetter]	GREEK SMALL LETTER OMEGA WITH DASIA AND PERISPOMENI AND YPOGEGRAMMENI
·æ∞	U+1FB0	[LowercaseLetter]	GREEK SMALL LETTER ALPHA WITH VRACHY
·æ±	U+1FB1	[LowercaseLetter]	GREEK SMALL LETTER ALPHA WITH MACRON
·æ≤	U+1FB2	[LowercaseLetter]	GREEK SMALL LETTER ALPHA WITH VARIA AND YPOGEGRAMMENI
·æ≥	U+1FB3	[LowercaseLetter]	GREEK SMALL LETTER ALPHA WITH YPOGEGRAMMENI
·æ¥	U+1FB4	[LowercaseLetter]	GREEK SMALL LETTER ALPHA WITH OXIA AND YPOGEGRAMMENI
·æ∂	U+1FB6	[LowercaseLetter]	GREEK SMALL LETTER ALPHA WITH PERISPOMENI
·æ∑	U+1FB7	[LowercaseLetter]	GREEK SMALL LETTER ALPHA WITH PERISPOMENI AND YPOGEGRAMMENI
·ææ	U+1FBE	[LowercaseLetter]	GREEK PROSGEGRAMMENI
·øÇ	U+1FC2	[LowercaseLetter]	GREEK SMALL LETTER ETA WITH VARIA AND YPOGEGRAMMENI
·øÉ	U+1FC3	[LowercaseLetter]	GREEK SMALL LETTER ETA WITH YPOGEGRAMMENI
·øÑ	U+1FC4	[LowercaseLetter]	GREEK SMALL LETTER ETA WITH OXIA AND YPOGEGRAMMENI
·øÜ	U+1FC6	[LowercaseLetter]	GREEK SMALL LETTER ETA WITH PERISPOMENI
·øá	U+1FC7	[LowercaseLetter]	GREEK SMALL LETTER ETA WITH PERISPOMENI AND YPOGEGRAMMENI
·øê	U+1FD0	[LowercaseLetter]	GREEK SMALL LETTER IOTA WITH VRACHY
·øë	U+1FD1	[LowercaseLetter]	GREEK SMALL LETTER IOTA WITH MACRON
·øí	U+1FD2	[LowercaseLetter]	GREEK SMALL LETTER IOTA WITH DIALYTIKA AND VARIA
·øì	U+1FD3	[LowercaseLetter]	GREEK SMALL LETTER IOTA WITH DIALYTIKA AND OXIA
·øñ	U+1FD6	[LowercaseLetter]	GREEK SMALL LETTER IOTA WITH PERISPOMENI
·øó	U+1FD7	[LowercaseLetter]	GREEK SMALL LETTER IOTA WITH DIALYTIKA AND PERISPOMENI
·ø†	U+1FE0	[LowercaseLetter]	GREEK SMALL LETTER UPSILON WITH VRACHY
·ø°	U+1FE1	[LowercaseLetter]	GREEK SMALL LETTER UPSILON WITH MACRON
·ø¢	U+1FE2	[LowercaseLetter]	GREEK SMALL LETTER UPSILON WITH DIALYTIKA AND VARIA
·ø£	U+1FE3	[LowercaseLetter]	GREEK SMALL LETTER UPSILON WITH DIALYTIKA AND OXIA
·ø§	U+1FE4	[LowercaseLetter]	GREEK SMALL LETTER RHO WITH PSILI
·ø•	U+1FE5	[LowercaseLetter]	GREEK SMALL LETTER RHO WITH DASIA
·ø¶	U+1FE6	[LowercaseLetter]	GREEK SMALL LETTER UPSILON WITH PERISPOMENI
·øß	U+1FE7	[LowercaseLetter]	GREEK SMALL LETTER UPSILON WITH DIALYTIKA AND PERISPOMENI
·ø≤	U+1FF2	[LowercaseLetter]	GREEK SMALL LETTER OMEGA WITH VARIA AND YPOGEGRAMMENI
·ø≥	U+1FF3	[LowercaseLetter]	GREEK SMALL LETTER OMEGA WITH YPOGEGRAMMENI
·ø¥	U+1FF4	[LowercaseLetter]	GREEK SMALL LETTER OMEGA WITH OXIA AND YPOGEGRAMMENI
·ø∂	U+1FF6	[LowercaseLetter]	GREEK SMALL LETTER OMEGA WITH PERISPOMENI
·ø∑	U+1FF7	[LowercaseLetter]	GREEK SMALL LETTER OMEGA WITH PERISPOMENI AND YPOGEGRAMMENI
